{
    "202": "🇦🇷", 
    "204": "🇧🇴", 
    "205": "🇧🇷", 
    "206": "🇨🇦", 
    "207": "🇨🇱", 
    "208": "🇨🇴", 
    "214": "🇨🇷", 
    "209": "🇪🇨", 
    "1038": "🇯🇲", 
    "203": "🇲🇽", 
    "2659": "🇵🇦", 
    "210": "🇵🇾", 
    "211": "🇵🇪", 
    "660": "🇺🇸", 
    "212": "🇺🇾", 
    "213": "🇻🇪"
}