{
    "585": "🇦🇱",
    "474": "🇦🇹",
    "459": "🇧🇪",
    "477": "🇭🇷",
    "450": "🇨🇿",
    "479": "🇩🇰",
    "448": "🏴󠁧󠁢󠁥󠁮󠁧󠁿",
    "478": "🇫🇷",
    "584": "🇬🇪",
    "481": "🇩🇪",
    "480": "🇭🇺",
    "162": "🇮🇹",
    "449": "🇳🇱",
    "471": "🇵🇱",
    "482": "🇵🇹",
    "473": "🇷🇴",
    "580": "🏴󠁧󠁢󠁳󠁣󠁴󠁿",
    "6757": "🇷🇸",
    "468": "🇸🇰",
    "472": "🇸🇮",
    "164": "🇪🇸",
    "475": "🇨🇭",
    "465": "🇹🇷",
    "457": "🇺🇦"
}